7
* *      *  **** ***     ***  **** ** *        * ***  * 
* *      * *    *** *   * ** *    *** *        **   *  *
* *      * ***    * *   * ** ***    * *           **** *
* *      *  ***   * *   * **  ***   * *          **** * 
* *      * *       * *** * * *      * *              * *
* ******** *******  *   *  * ******** *******  ******  *
******************   ***   ******************  ******** 