8
 *        *******           *******  *                  **   
* *      *  **** ***     ***  **** ** *                *  *  
* *      * *    *** *   * ** *    *** *                *** *
* *      * ***    * *   * ** *    * *                  * * 
* *      *  ***   * *   * **  ***   * *                  * * 
* *      * *       * *** * * *      * *                  * * 
* ******** *******  *   *  * ******** *******          *** **
******************   ***   ******************          ******
                                                             
