5
 *     ***** *     ***** *       **** 
* *   *  **** * ***  **** *     **   *
* *   *  *  * * ***  *  * *      *   *
* *****  ** * *** *  ** * ****  *   **
****************  ************  ******
                                     

